121
11 13
4 4 4 4 4 4 4 4 4 4 4 4 4
4 0 0 1 1 1 1 1 1 0 3 1 4
4 0 3 3 3 3 3 3 3 0 3 1 4
4 1 3 0 0 2 0 0 3 1 3 1 4
4 1 3 0 2 2 2 0 3 1 2 2 4
4 1 3 2 2 5 2 2 3 1 2 2 4
4 1 3 0 2 2 2 0 3 1 2 2 4
4 1 3 0 0 2 0 0 3 1 3 1 4
4 0 3 3 3 3 3 3 3 0 3 1 4
4 0 0 1 1 1 1 1 1 0 3 1 4
4 4 4 4 4 4 4 4 4 4 4 4 4