35
7 7
4 5 1 5 1 5 4
0 2 0 2 0 2 0
4 0 1 3 1 0 4
0 2 3 3 3 2 0
4 0 1 3 1 0 4
0 2 0 2 0 2 0
4 5 1 5 1 5 4